.............................................
.                                   . .     .
. . . . ..... ....... . . ........... . . ...
. . . .     .       . . .               .   .
. . . . . ......... ..... ............. .....
. . . . .   . .   .   .               . .   .
. . ......... . ... ... ... . . ....... . ...
. .     .   .     .   .   . . .       . .   .
. ....... ... ......... ... ... ... . ... ...
.   .                 .   .   .   . .       .
. ... ............. ..... ..... ... ... . . .
.                 .   .       . .     . . . .
... . . . . . . . ... ..... ... . . ....... .
.   . . . . . . .   .     .   . . .       . .
. . . . ... ... ... . ... ... . . . . . . ...
. . . .   .   .   . .   .   . . . . . . .   .
. ..... ... . . . ... . ........... . ... ...
.     .   . . . .   . .         .   .   .   .
. . ... . . . ... . . ... ... ..... .........
. .   . . . .   . . .   .   .   .     .     .
. . ... ... . . ..... ............... . ... .
. .   .   . . .     .       .     .       . .
. . ... ... ............. . . ....... . . . .
. .   .   .     . .     . .         . . . . .
. . ..... . ... . . ....... . . .............
. .     . . .             . . .     . . .   .
. . . . . . ..... ... ..... ... . ... . . ...
. . . . . .     . .       .   . .       . . .
. . . ....... . ... . . ..... . . . . . . . .
. . .   . .   . .   . .   .   . . . . .     .
. . . ... . . ... . . . . ... . ... ... . . .
. . . .   . .   . . . . . .   . .     . . . .
. . ... ..... . . ... . ... . ... . ... . . .
. .   .     . . .   . . . . .   . .   . . . .
. . . . ..... . . . ... . ....... . . ..... .
. . .       . . . . .           . . . .     .
. ... . ... . . . . ... . ..... . . . ... . .
.   . .   . . . . .   . .     . . . . .   . .
. ... . . ..... ... ..... . . . ........... .
.   . . .     .   .   .   . . .       . .   .
. . . . . ..... . ....... . ....... ... ... .
. . . . .   . . . .   . . .       . .   .   .
. ... . ..... . ..... . . ......... . . .....
.   . .       .   .               .   .     .
........................................... .