.....................................
. .                                 .
. ... ....... ........... ... ... ...
.           .           .   . . .   .
. . ... ..... . . ... ..... . . . ...
. .   .     . . .   .     . .   .   .
. ... . ....... . ...................
.   . .       . .     .             .
. . . ... . . . ..... . ..... . . . .
. . . .   . . .     .       . . . . .
. ... ... ... . ............... . . .
.   .   .   . .       .       . . . .
. ....... . ..... ..... .............
.   .   . .     .                   .
. ... . ... . . . ..... ........... .
.     .   . . . .     .           . .
... . ... . ..... . . ...............
.   .   . .     . . .               .
. . ... . . . ..... . ... ......... .
. . .   . . .   . . .   .         . .
. . . ... . . ... ... ... . .........
. . . .   . . . .       . .         .
. . . . . ... . ..... . . . ... .....
. . . . . .         . . . .   .     .
. ....... ... ..... . . . . . . .....
.       . .       . . . . . . .     .
. ... . ..... ..... . ... ..... . . .
.   . . .         . . .       . . . .
. ... . . ... . ... ... . . . ... ...
. .   . . .   .   .   . . . .   .   .
. ... . ..... ........... . ....... .
. . . .   .             . .       . .
... . ... ... . ... ... ... ..... . .
.       .   . .   .   . . .     . . .
....... ......... . ..... ..... ... .
.               . .           .   . .
................................... .