.....................
.     .   .         .
. ..... . . .........
.       . .         .
. ......... ....... .
.                 . .
. . . . ....... .....
. . . .       .     .
... ....... . . .....
.       .   . .   . .
. . . ....... ..... .
. . .       .       .
. ......... ....... .
.         .       . .
. . . ....... ..... .
. . .       .     . .
. . ....... ..... . .
. .       .     . . .
. . ... ........... .
. .   .           . .
................... .