.............
. .   . .   .
. . . . . ...
.   .       .
. ...........
.           .
. . .........
. .         .
. ..... .....
.   . .     .
. ... . . ...
.     . .   .
........... .