.............................................................
.       .           .           .         .                 .
. . ... . ..... . ... . . . ..... ... ... . ........... . . .
. .   .       . .   . . . .         . .               . . . .
. . ....... ... ..... . ..... ....... ... ............... . .
. .     . .   .       .     .       .   .               . . .
. . . . . ... . ....... . . . . . ....... . . . . . .........
. . . .     . .       . . . . . .     . . . . . . .         .
. . ......... ....... ..... ........... ..... ......... .....
. .         .       .     .                 .   . .   .     .
. ... ... . . . . ....... . ... ............. ... . . . . . .
.   .   . . . . .     .   .   .             .       . . . . .
. . . ... . ... . . ... . ..... ......... . ......... . . ...
. . .   . .   . . .   . .   .           . .         . . .   .
. . . ........... ... . . . . . . . . . ... ........... ... .
. . .           .   . . . . . . . . . .   .           .   . .
. . . . ... ..... . . ... . . . ....... . . . ..... ..... ...
. . . . .       . . .   . . . .       . . . .   .     . .   .
. . ... ... . ..... ....... ..... . ......... ... . ... . ...
. .   . .   .     . . . .       . .         .   . .     .   .
. . ... . . . ..... . . ..... ... . ..... ............. ... .
. . .   . . .     .   .     . . . .   .               .   . .
. ... . ... . . ....... ... . . . . . ... ....... . ..... . .
.   . . .   . . . .       . .   . . . .         . .     . . .
. . ... ... . . . ... . . . ... ... ......... . .............
. .   . .   . .       . . . . .   .       .   .             .
. . . . . ... . . . ..... . . ......................... ... .
. . . . .   . . . .     . .       .   .     .         .   . .
... . . ..... ... . . . ....... ... ... ..... ... ....... . .
.   . .   .     . . . .       .                 .   . .   . .
. . ... . . . . . ..... . ... ... ................... . ... .
. .   . . . . . .     . .   .   .     .         . .   .   . .
. . ..... ..... . . ... . . . . . . . . . . . . . . ... . ...
. .     . .     . .   . . . . . . . . . . . . .       . .   .
. ... ... ..... . . ......... . ... ... ... . . ... . . . ...
. .     . . .   . .         . .   .       . . .   . . . .   .
. . . ..... ..... . . ... ... ... ..... ....... ... . . ... .
. . . .           . .   .   .   .     .     .     . . . .   .
... . ........... . . . ......... . . ....... ..... ... ... .
.   .   .         . . .       .   . .       .     . .   .   .
... . . ... . . . ... ... . . ... ... . ........... ..... ...
.   . . . . . . . .     . . .   .   . .           .     .   .
. ..... . . . . . . ... ... ... . . ............. ....... ...
. .     .   . . . .   .   . .   . .             .       .   .
. . ... . ... . ... . . . ... ..... . . ................. ...
. .   . .   . .   . . . . .     .   . .                 .   .
. . ... . ... ... . . ... . ..... . . . . . ... ........... .
. .   . . .   .   . . .   .     . . . . . .   .       .   . .
. ... ..... . ... . . ... . . . . . . . . . ... . . ... .....
.   .   .   . .   . .   . . . . . . . . . .   . . .         .
. . ... . . . . . . . . ... ......... . . ....... . ... . . .
. .   . . . . . . . . .   .         . . .       . . . . . . .
... . ... . . . ... . ... ... . . ... ... ....... ... ... ...
.   . .   . . .   . . .   .   . .   . .         .       .   .
... . . . ... ... . . . . ... . . . . ..... . ..... . . ... .
.   . . . .   .   . . . . . . . . . .   .   .   .   . .   . .
. ... ... . ..... ... ... . . ... ... . . ... . . . ... ... .
.   .   . . .     .     .   .   . .   . . . . . . .   .   . .
. ..... . ..... . . . ....... ... . ..... . . ... ....... . .
.   .   . .     . . .     .     . .   .     .   .     .   . .
........................................................... .