.....................................................
.     .                   .             . .         .
. . ..... . ..... . ....... ... ..... ... . ....... .
. .   .   .     . . .     .   .     .           . . .
. . ... . ..... ..... ..... ..................... ...
. .     .     .                 .             .     .
. . . ... ......... . ..... ..... ..... . ... . ... .
. . .   .         . .     . .   .   . . .   .     . .
. . . . ... . ....... . ..... . . ... ......... .....
. . . . .   .       . .       .     .         .     .
. . . . ..... ... ..... . . . . . . . ... . ... .....
. . . . .       .   . . . . . . . .     . . .   .   .
. ......... . ... ... . ... ..... . . . ......... ...
.       .   .   .     .   .     . . . . . . .       .
. ......... . . ....... ... . ........... . . ... ...
.     . .   . .       . . . .         . .       .   .
... ... . ... . . ... . . . . . . . ... . ......... .
.       .   . . .   . .   . . . . .         .     . .
. . . . . ..... . ..... . ......... ..... ... ... . .
. . . . .   .   .     . .         .     .       . . .
. ... ... . ..... . ... . ... ..... . . ... . ..... .
. . .   . .     . .   . .   .     . . . .   .     . .
. . ..... . ... ... . . . . . ... ..... ... . .......
.   .     .   .   . . . . . .   .     .   . .       .
. . ..... ... ... . ... . . . ......... . ... . .....
. .   .     .   . .   . . . .         . .   . .     .
. . ... ..... . . ... ... ... . ..... ... . ... .....
. . .       . . .   .   .   . .     .   . .   .     .
... . . . . ... . . . . . . . . . . . . . . . . . ...
.   . . . .   . . . . . . . . . . . . . . . . . .   .
. ... . . . . . . ..... . . ... . . . . . ....... . .
. .   . . . . . .     . . . . . . . . . .       . . .
. . ... ... ... . . ... ... . ........... ......... .
. . .   .     . . . .     .             .         . .
. ....... . . ....... . . ..... ... . . . ... ... . .
.   .     . .     .   . .   .     . . . .   .   . . .
. . ... ... ... ... ..... ......... . . ........... .
. .   . .     .   .     .         . . .           . .
. . ..... ... . . . . ... . ....... ... ... ..... . .
. .   .     . . . . . .   .       .   .   .     . . .
. ... ..... . ... ... . . . . ..... ... ... .........
.   . .     .   .   . . . . .     .   .   .         .
... ..... . . ..... ... . . ... ....... . . . ..... .
.     . . . .     . . . . .   .     .   . . .     . .
... . . . . . . ..... . . . . . ..... . . . ... ... .
.   . .   . . .       . . . . .     . . . .   .   . .
... . . . ... . . ..... . ... . ... . . . . ... ... .
.   . . .   . . .     . .   . .   . . . . . .     . .
... ... ..... ... . ......... ... . . . ... ... .....
.   .     .   .   .         .   . . . .   .   .   . .
. . ......... . . ....... ..... ......... . ..... . .
. . .         . .       .     .       .   .     .   .
................................................... .