.............................
.             . .     .     .
. . ... ... ... ..... . .....
. .   . . . .   .           .
. . . . . ... ... ..... .....
. . . .     .         .   . .
. . . ....... ..... ... ... .
. . .           . . . .   . .
... ... ....... . ... . . . .
.   .         .       . .   .
. . . . . ... ......... .....
. . . . . .       .   .   . .
. ... . ..... ... . ....... .
.   . .   .     .         . .
. ... . ... ... ....... ... .
.   . . .   .         .     .
. . . . . ... . . . ... ... .
. . . . . .   . . .   .   . .
. . ... ... . . ... . ... ...
. . .   .   . .   . .   .   .
... ... . . . . ... . . . . .
.   .   . . . . .   . . . . .
. ... ..... . . . . . ... . .
. .     .   . . . . .   . . .
. . . ..... . . . . . . . . .
. . .   .   . . . . . . . . .
. . . ... ... ..... ... ... .
. . .   . .       .   .   . .
........................... .